11111111111111111111111
100100C0000C00000011111
10C00111110000000010001
1P0011E00C0000000010001
11111111111111001110001
1111C000000000000011111
11111110000000C0000C0C1
11111111111100001111111
100100C0000C00000011111
10C00111110000000010001
100011000C0000000010001
11111111111111001110001
1111C000000000000011111
11111110000000C0000C0C1
11111111111111111111111