1111111111
1111111111
10000C0001
10000C0001
10000C0001
1000E00001
1000P00001
10000C0001
10000C0001
10000C0001
10000C0001
10000C0001
1111111111
1111111111